AAAAAAAAAAAAAAAAAAAAAAAAAA
DDDDDDDDDDDDDDDDDDDDDDDDDD
DDDDDDDDTDDDDDDDDDDDTDDDDD
DDDDDDDDDDDDDDDDDDDDDDDDDD
DDDDDDDDDDDDDDTDDDDDDDDDDD
DDDTDDDDDDDDDDDDDDDDDDDDDD
DDDDDDDDDDDDDDDDDDDDDDDDDD
DDDDDDDDDDDDDDDDDDDDDDDDDD
